++++++++++++++++++++
+                  ]
+        @         +
+                  +
+     #     #      +
+                  +
+                  +
+   @         @    +
+                  +
+   #    #    #    +
+                  +
+#       @         +
+                  +
+X                 +
++++++++++++++++++++

