++++++++++++++++++++
+    #   #   #     ]
+        #         +
+                  +
+     #     #      +
+        #         +
+        #  @      +
+     # # # #      +
+    #       #     +
+   #  # # #  #    +
+        #  @      +
+#  #    #    #   #+
+     ##   ##      +
+X                 +
++++++++++++++++++++

