++++++++++++++++++++
+                  ]
+        #         +
+     @     @      +
+     #     #      +
+     +++++++      +
+                  +
+   @         @    +
+                  +
+   #    #    #    +
+                  +
+#     # @ #      #+
+                  +
+X                 +
++++++++++++++++++++

