++++++++++++++++++++
+                  ]
+        #         +
+     @     @      +
+     #     #      +
+     +++++++      +
+                  +
+   @         @    +
+  #           #   +
+   #    #    #    +
+                  +
+#     #   #      #+
+                  +
+X                 +
++++++++++++++++++++

