++++++++++++++++++++
+                  ]
+        ##        +
+          @       +
+     #  @   #     +
+     ++++++++     +
+                  +
+         #        +
+   #           #  +
+    #    #    #   +
+     #+++ +++#    +
+#     + @ @ +    #+
+      +     +     +
+X                 +
++++++++++++++++++++

