++++++++++++++++++++
+@         #      @]
+         #        +
+        #         +
+       #          +
+      #           +
+     #            +
+    #             +
+   #              +
+  #               +
+ #                +
+#                 +
+                  +
+X                @+
++++++++++++++++++++

