++++++++++++++++++++
+          #       ]
+         # +      +
+        #         +
+       #   +      +
+     @#           +
+    @#     +      +
+    #             +
+   #       +      +
+  #               +
+ #         +      +
+#                 +
+                  +
+X                 +
++++++++++++++++++++

